$$$$$$$$$$$$$$$$$$$%%%$$$$$$$$$$$$$$$$$@@@@@@$%%^^^^^^^^^^^^^^%%$@@@@@@@$$$$$$$$
$$$$$$$$$$$$$$%^^^^^^^^^^^^^%%$$$$$$$$@@@@@@%^^^^^^^^^^^^^^^^^^^^^%$$@$$$$$$$$$$
$$$$$$$$$$@@@$^%%^^^^^^^^^^^^^^^%$$$$$$@@@@$^^^^^^^^^^^^^^^^^^^^^^^^^$$$$$$$$$$$
$$$$$$@@@@@$@$^^^^^^^^^^^^^^^^^^^^^%$$$$$@@@%^^^^^^^^^^^^^^^^^^^^^^^^^$$$$$$$$$$
$$$$$$$$$$$$%%^^^^^^^^^^^^^^^^^^^^^^^%$$$@$$%^^^^^^^^^^^^^^^^^^^^^^^^^$$$$$$$@@@
$$$$$$$$$^^^^^^^^^^^^^^^^^^^^^^^^^^^^^$$@$^^^^^^^^%%%%%%%%%^^^^^^^^^%$@@@@@@@@@@
$$$$$$$$$$$%^^%^^^%%%%%^^^^^^^^^^^^^^^$$@$%^^^%%%%^^^^^^%%%%^^^^^%^%@@@@@@@@@@@@
$$$$$$$$$@@@$%%%^%%%%%%%^^^^^%%%^^^%$$$$$$@@@%^^^%%^^%%%%%%%%^%%%%%$@@@@@@@@@@@@
$$$$$$$$$@@$%%%%%%%%%%%%^^^^^%%^^^$@@@@$$$$@@@$%%%%%%%%%%%%%%^%%%%^%@@@@@@@@@@@$
$$$$$$$$$@@$%^^%%%%%%%%%%^%%%^^^^%@@@@@@@@@@@@@$%%^^%%%%%%%%%%%%%%^%@@@@@@$$$$$$
$$$$$$$$$$$$^^^^%%%%%%%%%^%%%^^^^^$@@@@@@@@@@@@@%^^^^^^^%%%%%%%%$%%$@@@@@$$$@@$$
$$$$$$%%$$$$%%%%%%%%%%^%%%^%%%^^^^$@@@@@@$$$$@@@$%%^%%^^^%^%^^%%%%%%%$%%%$$$$$$@
$$$$$%%$@@$%%%%%%%^^^^^^^^^%%%%^^^^%$$@$$$$$$$@@@@%%%^^^^^^^^%%%%%%^^^^^^^^^^^^^
$$$$$@@@$$%%%%%%%^^^^^^^^^^%%%^^^^^^^^^%$@@@@@@@@@@$$$$^^^^%%%%%^^^^%^^^^^^^^^^^
$$$$%^^^^^%%^^^^^^^^^^^^^%%^^^^^^^^^^^^^^%%%$$@@@@@@@@$%%%%%%^^^^^^%%^^^^^^^^^^^
$$$$$%^^^^^^^^^^^^^^^^%%%^^^^^%^^^^^^^^^^^^^^^^%$@@@@$%^%%%^^^^^^^^^^^^^^^^^^^^^
$$$$@$%^^^^^^^^^^^^^^^^^^^^^^^^^^^^^^^^^^^^^^^^^^%$@$%^^^^%%%^^^^^^^^^^^^^^^^^^^
$$$$^^^^^^^^^^^^^^^^^^^^^^^^^^^^^^^^^^^^^^^^^^^^^^^^^^^^^^^^^^^^^^^^^^^^^^^^^^^^
$%^^^^^^^^^^^^^^^^^^^^^^^^^^^^^^^^^^^^^^^^^^^^^^^^^^^^^%%%%^^^^^^^^^^^^^^^^^^^^^
